##########################
#        #######         #
#        #######         #
#        #######         #
#       #########        #
#       #########        #
#         #####          #
#                        #
#                        #
#     ##                 #
#########        ##      #
#########      ###########
#########      ###########
########        ##########
#     #          ##      #
#                        #
#                        #
#                        #
#         ####           #
#         ####           #
#      ##########        #
#      ##########        #
#        ######          #
#        ######          #
#        ######          #
##########################
