##########################
##########################
#     ##########         #
#        #######         #
#                        #
#                        #
#                      ###
#                      ###
#                      ###
#                       ##
#                       ##
#                        #
#                        #
#                        #
#                        #
#                        #
###                      #
###                      #
###                      #
###                    ###
#                      ###
#                      ###
#                      ###
#      ########          #
#      ########          #
##########################
