############################
#           ###            #
#           ###            #
#         #######         ##
##       #########        ##
#        #########      ####
#         #######          #
#                          #
#     ##                   #
#   ######            #    #
###########          ###   #
###########        #########
#   ######        ##########
#   ######          ########
#     ###           ####   #
#                          #
#                          #
####         ####          #
###        #######         #
#         #########        #
#           #####         ##
#           #####          #
#    #      #####          #
############################