############################
#        ######            #
#        ######            #
#          ##              #
#                          #
#                          #
#                          #
#                          #
##                     #####
#                      #####
#                      #####
####                   #####
#                          #
#                          #
#                          #
#                          #
#####                      #
#####                      #
#####                      #
#####                      #
#                          #
#              ####        #
#              ####        #
############################